{
  "name": "First Map of this f*cking game",
  "map": [
    [9, 9, 9, 9, 9, 9, 9, 9, 9, 9, 9, 9, 9, 9, 9, 9, 9, 9, 9, 9, 9, 9, 9, 9, 9, 9, 9, 9],
    [9, 2, 2, 2, 2, 2, 2, 2, 2, 2, 2, 2, 2, 9, 9, 2, 2, 2, 2, 2, 2, 2, 2, 2, 2, 2, 2, 9],
    [9, 2, 9, 9, 9, 9, 2, 9, 9, 9, 9, 9, 2, 9, 9, 2, 9, 9, 9, 9, 9, 2, 9, 9, 9, 9, 2, 9],
    [9, 2, 9, 9, 9, 9, 2, 9, 9, 9, 9, 9, 2, 9, 9, 2, 9, 9, 9, 9, 9, 2, 9, 9, 9, 9, 2, 9],
    [9, 2, 9, 9, 9, 9, 2, 9, 9, 9, 9, 9, 2, 9, 9, 2, 9, 9, 9, 9, 9, 2, 9, 9, 9, 9, 2, 9],
    [9, 2, 2, 2, 2, 2, 2, 2, 2, 2, 2, 2, 2, 2, 2, 2, 2, 2, 2, 2, 2, 2, 2, 2, 2, 2, 2, 9],
    [9, 2, 9, 9, 9, 9, 2, 9, 9, 2, 9, 9, 9, 9, 9, 9, 9, 9, 2, 9, 9, 2, 9, 9, 9, 9, 2, 9],
    [9, 2, 9, 9, 9, 9, 2, 9, 9, 2, 9, 9, 9, 9, 9, 9, 9, 9, 2, 9, 9, 2, 9, 9, 9, 9, 2, 9],
    [9, 2, 2, 2, 2, 2, 2, 9, 9, 2, 2, 2, 2, 9, 9, 2, 2, 2, 2, 9, 9, 2, 2, 2, 2, 2, 2, 9],
    [9, 9, 9, 9, 9, 9, 2, 9, 9, 9, 9, 9, 2, 9, 9, 2, 9, 9, 9, 9, 9, 2, 9, 9, 9, 9, 9, 9],
    [0, 0, 0, 0, 0, 9, 2, 9, 9, 2, 2, 2, 2, 2, 2, 2, 2, 2, 2, 9, 9, 2, 9, 0, 0, 0, 0, 0],
    [0, 0, 0, 0, 0, 9, 2, 9, 9, 2, 9, 9, 9, 8, 8, 9, 9, 9, 2, 9, 9, 2, 9, 0, 0, 0, 0, 0],
    [0, 0, 0, 0, 0, 9, 2, 2, 2, 2, 9, 8, 8, 8, 8, 8, 8, 9, 2, 2, 2, 2, 9, 0, 0, 0, 0, 0],
    [0, 0, 0, 0, 0, 9, 2, 9, 9, 2, 9, 9, 9, 9, 9, 9, 9, 9, 2, 9, 9, 2, 9, 0, 0, 0, 0, 0],
    [0, 0, 0, 0, 0, 9, 2, 9, 9, 2, 2, 2, 2, 1, 2, 2, 2, 2, 2, 9, 9, 2, 9, 0, 0, 0, 0, 0],
    [0, 0, 0, 0, 0, 9, 2, 9, 9, 2, 9, 9, 9, 9, 9, 9, 9, 9, 2, 9, 9, 2, 9, 0, 0, 0, 0, 0],
    [9, 9, 9, 9, 9, 9, 2, 9, 9, 2, 9, 9, 9, 9, 9, 9, 9, 9, 2, 9, 9, 2, 9, 9, 9, 9, 9, 9],
    [9, 2, 2, 2, 2, 2, 2, 2, 2, 2, 2, 2, 2, 9, 9, 2, 2, 2, 2, 2, 2, 2, 2, 2, 2, 2, 2, 9],
    [9, 2, 9, 9, 9, 9, 2, 9, 9, 9, 9, 9, 2, 9, 9, 2, 9, 9, 9, 9, 9, 2, 9, 9, 9, 9, 2, 9],
    [9, 2, 9, 9, 9, 9, 2, 9, 9, 9, 9, 9, 2, 9, 9, 2, 9, 9, 9, 9, 9, 2, 9, 9, 9, 9, 2, 9],
    [9, 2, 9, 9, 9, 9, 2, 9, 9, 9, 9, 9, 2, 9, 9, 2, 9, 9, 9, 9, 9, 2, 9, 9, 9, 9, 2, 9],
    [9, 2, 2, 2, 2, 2, 2, 2, 2, 2, 2, 2, 2, 2, 2, 2, 2, 2, 2, 2, 2, 2, 2, 2, 2, 2, 2, 9],
    [9, 2, 9, 9, 9, 9, 2, 9, 9, 2, 9, 9, 9, 9, 9, 9, 9, 9, 2, 9, 9, 2, 9, 9, 9, 9, 2, 9],
    [9, 2, 9, 9, 9, 9, 2, 9, 9, 2, 9, 9, 9, 9, 9, 9, 9, 9, 2, 9, 9, 2, 9, 9, 9, 9, 2, 9],
    [9, 2, 2, 2, 2, 2, 2, 9, 9, 2, 2, 2, 2, 2, 2, 2, 2, 2, 2, 9, 9, 2, 2, 2, 2, 2, 2, 9],
    [9, 9, 9, 9, 9, 9, 9, 9, 9, 9, 9, 9, 9, 9, 9, 9, 9, 9, 9, 9, 9, 9, 9, 9, 9, 9, 9, 9]
  ]
}
